...........g...
..g...pg...pw..
.pg....g.......
....gp.........
wp.w...g.......
.g.w....w......
.p..p.p..wp....
....w.p......w.