.....w.....pp..
..g...w..pggg..
.....p.w.......
........gw..pw.
p..g..g......ww
........p......
........p...w..
p.pg...........