........g.....g
..p...g.w...g..
pg.www..p......
........p..p...
p....p...g....g
....w..........
...w...w...p..p
g.........p.w..