..............w
..p..g..w......
....pg.gw....p.
....w..ppp...g.
.gw..........gw
...g..w.p...g..
pp......p.w....
...............