.......pp.....g
..wp.w.w....gw.
...g.g.........
.......p.......
.p.wpp...p.g.p.
..w..w....g....
.g....p.g...w..
...............