.........w....w
...g..p........
gg......g..w...
wp..g.......gp.
......p.p....w.
g.p......w..g.p
p...w...p....w.
....p..........