.......wg.w.w..
........pw..p.g
w....p......g.w
..w.........gp.
...............
......p....p..g
...g..p.......p
.gpw....p....g.