..p.pggwwp.....
....p..g..w...p
....w.w.g....gw
..p.......p...g
...p...p.....w.
.......g.......
...............
...g......w...p