.....g.g.......
..........wp...
..pg.pp......w.
.g...g.........
..w......g.p...
w...p......w.g.
g....p....w.p..
.p......w.w...p