....p.w.w......
..pp.....w.pw.p
......w........
.w...gp........
.......g.g.p...
...w...........
g.....w...p.g..
pg...g.......gp